teEtn0te000E00t0E00t0n0t0e00e0n0E0t0nt00
nt00E0000t0ne00e0h0n0e0Ee0t0000E000E00n0
t0n00t0n000n00E0st0eE0E0000t0t0t0E0etn00
E000et00tn0100E00t00n000e00EE0000t0ntnE0
e0E00nE0eL22222222222222DEn00teeecE0t0e0
nt00ne0tn4E00t0e00tt01005000000nE40tenE0
t0t0E0t0140t0E0en0t00e0150n00e0t0400n0t0
X22222222d0e0E0000eE00n05h00E00t0400e000
e00t1E0t0E0e00n0000h0E0t50t0000n04t00E00
e0000n0tn000n00000tE0e0n5E001E0t0410E00E
0t0e00E0e00n00000e0hh0e0l22222222d0e000E
n0E0n000000t0E0n0E0ss0000E0000n00e000000
et00n0t0000e0n0eEh00t0e00E0000E0t0n0E000
00E0eEt0n0t0n0h00s00e00nt0E00e00e000t0e0
e00n00t0t00tetsen00nE00e0t000t00e0e000n0
000n0e0E00000000000000000000000t00En0000
t0E0t00E00ene0Etee0ete0eEte00Et0t00e00e0
e0e00nt0e00e00n0E00t0n0t0e00e0n0E0t0nt00
t00E0E0n0000t0000n00E00nEn0e00t00e00e000
0e0tt0En0t0e0nE0EEn0E0t0t0t0e0ne0e00n0E0
teEtn00e000E00t0E00t0n0t0e00e0n0E0t0nt00

1::3
1::7
1::3||2::1||1::4
1::10||2::2||1::5
1::5||2::2||1::7||2::4||1::3