teEtn00e000E00t0E00t0n0t0e00e0n0E0t0nt00
0000E0000t0ne00e000n0e0Ee0t0000Ec00E00n0
00t00t0n000n00E00t0eE0E0010t0t0t4E0etn00
t000et00tn0100E00t00nL2222222222dt0ntnE0
00E000000L22222Dn0e004100En00teee0E0t0e0
0t00n000n4000t0500tt0g333333R00nE00tenE0
00t0E0t0140t0E0500000e0100004e0t0n00n0t0
X22222222d0e0E0500eE00n00h00410t0E00e000
000t0E0t0E0e00n5100h0E000000400n00t00E00
e0000n0tn000n00500t0000n0E004E0t0n000E00
0t0e00001G33333r0e0hh0e00h01400nE0n0e000
00E0n0000500000n000ss0000E0040n00e000000
et00n0t005100n0e0h0000000E004000t0n0E000
00E0eEt0n500n0h00s00000n00004000e000t0e0
e00n00t0t5100tsen00n000e0t004100e0e000n0
000n00000l222222222222222222d00t00En0000
t0E0t00E00ene0Eteee1ete0eEte00E0t00e00e0
e0e00n00e00e00n0E00t0n0t0e00e0n0E0t0nt00
t00E0E0n0000t0000n00E00nEn0e00t00e00e000
0e0tt0En0t0e0nE0EEn0E0t0t0t0e0ne0e00n0E0
teEtn00e000E00t0E00t0n0t0e00e0n0E0t0nt00

1::3
1::5||2::1
1::7||2::3
1::12||2::5||3::1