teEtn0te000E00t0E00t0n0t0e00e0n0E0t0nt00
nt00E0000t0ne00e0h0n0e0Ee0t0000E000E00n0
t0n00t0n000n00E0st0eE0E0000t0t0t0E0etn00
0000000000L222222222222222222222222D0000
0000000000410000000010000000000000150000
0000100000400000000000000000000000050000
0000000000410000000000000000100000051000
0000000000g333333333333R0000000000050000
0000000000000000000000140000000000050000
0000000000000000000000040000000000050000
0000000000000000000000040000000000050000
0000000000000000000000040000000000050000
0000000000100000000100040010000000051000
0000000000000000000000040000000000050000
0000000000000000000000040000000000150000
0000000000000000000000040000000000050000
0000000000000000000000140000000000050000
X2222222222222222222222d00100000000c0000
teEtn0te001E00t0E00t0n0t0e00e0n0E0t0nt00
nt00E0000t0ne00e0h0n0e0Ee0t0000E000E00n0
t0n00t0n000n00E0st0eE0E0000t0t0t0E0etn00

1::6
1::7||2::2
1::3||2::1||1::5||2::3||3::1
1::5||2::3||1::3|2::5||1::10
1::5||2::2||1::5||2::3||3::1||2::3||1::6||2::5||1::4
3::1||1::5||2::7||1::7||3::2||1::3||2::1||1::5||2::3||3::11||::5||2::3||1::3|2::5||1::10
1::3||2::1||1::5||2::3||3::1||1::5||2::3||1::3|2::5||1::10||1::5||2::2||1::5||2::3||3::1||2::3||1::6||2::5||1::4||1::3||2::1||1::5||2::3||3::1